Alias	RecipientFilter
DDG_AMS_ALL	((((((CustomAttribute3 -eq 'LBG') -or (CustomAttribute3 -eq 'AMS') -or (CustomAttribute3 -eq 'UK'))) -and (CustomAttribute4 -eq 'Employee') -and (RecipientType -eq 'UserMailbox'))) ))
ddg_bhz_all	((((CustomAttribute3 -eq 'BHZ') -and (CustomAttribute4 -eq 'Employee') -and (RecipientType -eq 'UserMailbox'))) ))
DDG_BJS_ALL	((((CustomAttribute3 -eq 'BJS') -and (CustomAttribute4 -eq 'Employee') -and (RecipientType -eq 'UserMailbox'))) ))
DDG_BNA_ALL	((((((CustomAttribute3 -eq 'MCN') -or (CustomAttribute3 -eq 'BNA'))) -and (CustomAttribute4 -eq 'Employee') -and (RecipientType -eq 'UserMailbox'))) ))
ddg_bra_all	((((((CustomAttribute3 -eq 'ELEB') -or (CustomAttribute3 -eq 'BHZ') -or (CustomAttribute3 -eq 'BOT') -or (CustomAttribute3 -eq 'BSB2') -or (CustomAttribute3 -eq 'CGR') -or (CustomAttribute3 -eq 'EGM') -or (CustomAttribute3 -eq 'ESC') -or (CustomAttribute3 -eq 'ETTE') -or (CustomAttribute3 -eq 'FLN') -or (CustomAttribute3 -eq 'GPX') -or (CustomAttribute3 -eq 'PTE') -or (CustomAttribute3 -eq 'SJK') -or (CustomAttribute3 -eq 'SOD') -or (CustomAttribute3 -eq 'TTE') -or (CustomAttribute3 -eq 'VCP') -or (CustomAttribute3 -eq 'BSB'))) -and (CustomAttribute4 -eq 'Employee') -and (RecipientType -eq 'UserMailbox'))) ))
BOT	((((CustomAttribute3 -eq 'BOT') -and (CustomAttribute4 -eq 'Employee') -and (RecipientType -eq 'UserMailbox'))) ))
ddg_fln_all	((((CustomAttribute4 -eq 'Employee') -and (((CustomAttribute9 -eq 'FLN1') -or (CustomAttribute9 -eq 'FLN'))) -and (RecipientType -eq 'UserMailbox'))) ))
DDG_EVE_EGM	((((CustomAttribute3 -eq 'EVE') -and (CustomAttribute4 -eq 'Employee') -and (RecipientType -eq 'UserMailbox'))) ))
DDG_EMEA_ALL	((((((CustomAttribute3 -eq 'UK') -or (CustomAttribute3 -eq 'SIN') -or (CustomAttribute3 -eq 'PRT') -or (CustomAttribute3 -eq 'NZD') -or (CustomAttribute3 -eq 'Moscow') -or (CustomAttribute3 -eq 'MIMO') -or (CustomAttribute3 -eq 'LBG') -or (CustomAttribute3 -eq 'JPN') -or (CustomAttribute3 -eq 'JOR') -or (CustomAttribute3 -eq 'JNB') -or (CustomAttribute3 -eq 'IND') -or (CustomAttribute3 -eq 'HUN') -or (CustomAttribute3 -eq 'FRA') -or (CustomAttribute3 -eq 'EVO') -or (CustomAttribute3 -eq 'DXB') -or (CustomAttribute3 -eq 'DEU') -or (CustomAttribute3 -eq 'Brussels') -or (CustomAttribute3 -eq 'BJS') -or (CustomAttribute3 -eq 'AUS') -or (CustomAttribute3 -eq 'AMS'))) -and (CustomAttribute4 -eq 'Employee') -and (RecipientType -eq 'UserMailbox'))) ))
ddg_ede_all	((((((CustomAttribute3 -eq 'ETTE') -or (CustomAttribute3 -eq 'ELEB') -or (CustomAttribute3 -eq '9901'))) -and (CustomAttribute4 -eq 'Employee') -and (RecipientType -eq 'UserMailbox'))) ))
ddg_egm_all	((((CustomAttribute3 -eq 'EGM') -and (CustomAttribute4 -eq 'Employee') -and (RecipientType -eq 'UserMailbox'))) ))
DDG_FLL_ALL	((((CustomAttribute3 -eq 'FLL') -and (CustomAttribute4 -eq 'Employee') -and (RecipientType -eq 'UserMailbox'))) ))
DDG_EVO_ALL	((((CustomAttribute3 -eq 'EVO') -and (CustomAttribute4 -eq 'Employee') -and (RecipientType -eq 'UserMailbox'))) ))
ddg_bsb_all	((((CustomAttribute3 -eq 'BSB') -and (CustomAttribute4 -eq 'Employee') -and (RecipientType -eq 'UserMailbox'))) ))
ddg_esc_all	((((CustomAttribute3 -eq 'ESC') -and (CustomAttribute4 -eq 'Employee') -and (RecipientType -eq 'UserMailbox'))) ))
DDG_EUA_ALL	((((((CustomAttribute3 -eq 'MEM') -or (CustomAttribute3 -eq 'TIX') -or (CustomAttribute3 -eq 'BDL') -or (CustomAttribute3 -eq 'Z4_OFF_US') -or (CustomAttribute3 -eq 'Z3_OFF_US') -or (CustomAttribute3 -eq 'Z2_OFF_US') -or (CustomAttribute3 -eq 'TITUS') -or (CustomAttribute3 -eq 'MQY') -or (CustomAttribute3 -eq 'MLB') -or (CustomAttribute3 -eq 'MCN') -or (CustomAttribute3 -eq 'LAX') -or (CustomAttribute3 -eq 'JAX') -or (CustomAttribute3 -eq 'FLL') -or (CustomAttribute3 -eq 'CAN_OFF_US') -or (CustomAttribute3 -eq 'BOS') -or (CustomAttribute3 -eq 'BNA') -or (CustomAttribute3 -eq 'AZ'))) -and (CustomAttribute4 -eq 'Employee') -and (RecipientType -eq 'UserMailbox'))) ))
DDG_DUB_ALL	((((CustomAttribute4 -eq 'Employee') -and (CustomAttribute9 -eq 'DXB') -and (RecipientType -eq 'UserMailbox'))) ))
DDG_FRA_ALL	((((((CustomAttribute3 -eq 'MIMO') -or (CustomAttribute3 -eq 'LBG') -or (CustomAttribute3 -eq 'FRA'))) -and (CustomAttribute4 -eq 'Employee') -and (RecipientType -eq 'UserMailbox'))) ))
DDG_GER_ALL	((((CustomAttribute3 -eq 'DEU') -and (CustomAttribute4 -eq 'Employee') -and (RecipientType -eq 'UserMailbox'))) ))
ddg_gpx_all	((((CustomAttribute3 -eq 'GPX') -and (CustomAttribute4 -eq 'Employee') -and (RecipientType -eq 'UserMailbox'))) ))
DDG_IWA_ALL	((((CustomAttribute3 -eq 'AZ') -and (CustomAttribute4 -eq 'Employee') -and (RecipientType -eq 'UserMailbox'))) ))
DDG_JAX_ALL	((((CustomAttribute3 -eq 'JAX') -and (CustomAttribute4 -eq 'Employee') -and (RecipientType -eq 'UserMailbox'))) ))
DDG_LAX_ALL	((((CustomAttribute3 -eq 'LAX') -and (CustomAttribute4 -eq 'Employee') -and (RecipientType -eq 'UserMailbox'))) ))
MLB	((((CustomAttribute3 -eq 'MLB') -and (CustomAttribute4 -eq 'Employee') -and (RecipientType -eq 'UserMailbox'))) ))
DDG_MQY_ALL	((((CustomAttribute3 -eq 'MQY') -and (CustomAttribute4 -eq 'Employee') -and (RecipientType -eq 'UserMailbox'))) ))
DDG_PORT_ALL	((((CustomAttribute4 -eq 'Employee') -and (CustomAttribute9 -eq 'PRT') -and (RecipientType -eq 'UserMailbox'))) ))
ddg_pte_all	((((CustomAttribute3 -eq 'PTE') -and (CustomAttribute4 -eq 'Employee') -and (RecipientType -eq 'UserMailbox'))) ))
DDG_NZD_ALL	((((CustomAttribute3 -eq 'NZD') -and (CustomAttribute4 -eq 'Employee') -and (RecipientType -eq 'UserMailbox'))) ))
DDG_SIN_ALL	((((CustomAttribute3 -eq 'SIN') -and (CustomAttribute4 -eq 'Employee') -and (RecipientType -eq 'UserMailbox'))) ))
DDG_RUSS_ALL	((((CustomAttribute3 -eq 'Moscow') -and (CustomAttribute4 -eq 'Employee') -and (RecipientType -eq 'UserMailbox'))) ))
ddg_sjk_all	((((CustomAttribute3 -eq 'SJK') -and (CustomAttribute4 -eq 'Employee') -and (RecipientType -eq 'UserMailbox'))) ))
DDG_TITUS_ALL	((((CustomAttribute3 -eq 'TITUS') -and (RecipientType -eq 'UserMailbox'))) ))
DDG_STHAFRICA_ALL	((((CustomAttribute3 -eq 'JNB') -and (CustomAttribute4 -eq 'Employee') -and (RecipientType -eq 'UserMailbox'))) ))
DDG_SOD_ALL	((((CustomAttribute3 -eq 'SOD') -and (CustomAttribute4 -eq 'Employee') -and (RecipientType -eq 'UserMailbox'))) ))
ddg_tte_all	((((CustomAttribute3 -eq 'TTE') -and (CustomAttribute4 -eq 'Employee') -and (RecipientType -eq 'UserMailbox'))) ))
DDG_UK_ALL	((((((CustomAttribute3 -eq 'Brussels') -or (CustomAttribute3 -eq 'UK'))) -and (CustomAttribute4 -eq 'Employee') -and (RecipientType -eq 'UserMailbox'))) ))
ddg_vcp_all	((((((CustomAttribute3 -eq 'CGR') -or (CustomAttribute3 -eq 'VCP'))) -and (RecipientType -eq 'UserMailbox'))) ))
DG_EMB_DIRETORES-EDE	((((((CustomAttribute3 -eq '9901') -or (CustomAttribute3 -eq 'ELEB') -or (CustomAttribute3 -eq 'ETTE'))) -and (((CustomAttribute5 -eq 'L2') -or (CustomAttribute5 -eq 'L2A') -or (CustomAttribute5 -eq 'L2B'))) -and (RecipientType -eq 'UserMailbox'))) ))
DG_EMB_DIRETORES-MLB	((((CustomAttribute3 -eq 'MLB') -and (((CustomAttribute5 -eq 'L2') -or (CustomAttribute5 -eq 'L2A') -or (CustomAttribute5 -eq 'L2B'))) -and (RecipientType -eq 'UserMailbox'))) ))
DG_EMB_DIRETORES-ESC	((((CustomAttribute3 -eq 'ESC') -and (((CustomAttribute5 -eq 'L2') -or (CustomAttribute5 -eq 'L2A') -or (CustomAttribute5 -eq 'L2B'))) -and (RecipientType -eq 'UserMailbox'))) ))
DG_EMB_DIRETORES-BOT	((((CustomAttribute3 -eq 'BOT') -and (((CustomAttribute5 -eq 'L2B') -or (CustomAttribute5 -eq 'L2A') -or (CustomAttribute5 -eq 'L2'))) -and (RecipientType -eq 'UserMailbox'))) ))
DG_EMB_DIRETORES-EGM	((((CustomAttribute3 -eq 'EGM') -and (((CustomAttribute5 -eq 'L2') -or (CustomAttribute5 -eq 'L2A') -or (CustomAttribute5 -eq 'L2B'))) -and (RecipientType -eq 'UserMailbox'))) ))
DG_EMB_DIRETORES-SJK	((((CustomAttribute3 -eq 'SJK') -and (((CustomAttribute5 -eq 'L2') -or (CustomAttribute5 -eq 'L2A') -or (CustomAttribute5 -eq 'L2B'))) -and (RecipientType -eq 'UserMailbox'))) ))
DG_EMB_DIRETORES-FLL	((((CustomAttribute3 -eq 'FLL') -and (((CustomAttribute5 -eq 'L2') -or (CustomAttribute5 -eq 'L2A') -or (CustomAttribute5 -eq 'L2B'))) -and (RecipientType -eq 'UserMailbox'))) ))
DG_EMB_DIRETORES-BSB	((((CustomAttribute3 -eq 'BSB') -and (((CustomAttribute5 -eq 'L2') -or (CustomAttribute5 -eq 'L2A') -or (CustomAttribute5 -eq 'L2B'))) -and (RecipientType -eq 'UserMailbox'))) ))
DG_EMB_DIRETORES-BJS	((((CustomAttribute3 -eq 'BJS') -and (((CustomAttribute5 -eq 'L2') -or (CustomAttribute5 -eq 'L2A') -or (CustomAttribute5 -eq 'L2B'))) -and (RecipientType -eq 'UserMailbox'))) ))
DG_EMB_DIRETORES-AMS	((((((CustomAttribute3 -eq 'AMS') -or (CustomAttribute3 -eq 'UK'))) -and (((CustomAttribute5 -eq 'L2B') -or (CustomAttribute5 -eq 'L2A') -or (CustomAttribute5 -eq 'L2'))) -and (RecipientType -eq 'UserMailbox'))) ))
DG_EMB_DIRETORES-GPX	((((CustomAttribute3 -eq 'GPX') -and (((CustomAttribute5 -eq 'L2') -or (CustomAttribute5 -eq 'L2A') -or (CustomAttribute5 -eq 'L2B'))) -and (RecipientType -eq 'UserMailbox'))) ))
DG_EMB_DIRETORES-VCP	((((CustomAttribute3 -eq 'VCP') -and (((CustomAttribute5 -eq 'L2') -or (CustomAttribute5 -eq 'L2A') -or (CustomAttribute5 -eq 'L2B'))) -and (RecipientType -eq 'UserMailbox'))) ))
DG_EMB_GERENTES-VCP	((((CustomAttribute3 -eq 'VCP') -and (((CustomAttribute5 -eq 'L3') -or (CustomAttribute5 -eq 'L3A') -or (CustomAttribute5 -eq 'L3B'))) -and (RecipientType -eq 'UserMailbox'))) ))
DG_EMB_GERENTES-BNA	((((CustomAttribute3 -eq 'BNA') -and (((CustomAttribute5 -eq 'L3') -or (CustomAttribute5 -eq 'L3A') -or (CustomAttribute5 -eq 'L3B'))) -and (RecipientType -eq 'UserMailbox'))) ))
DG_EMB_GERENTES-SIN	((((CustomAttribute3 -eq 'SIN') -and (((CustomAttribute5 -eq 'L3') -or (CustomAttribute5 -eq 'L3A') -or (CustomAttribute5 -eq 'L3B'))) -and (RecipientType -eq 'UserMailbox'))) ))
DG_EMB_GERENTES-PRT	((((((CustomAttribute5 -eq 'L3') -or (CustomAttribute5 -eq 'L3A') -or (CustomAttribute5 -eq 'L3B'))) -and (CustomAttribute9 -eq 'PRT') -and (RecipientType -eq 'UserMailbox'))) ))
DG_EMB_GERENTES-EGM	((((CustomAttribute3 -eq 'EGM') -and (((CustomAttribute5 -eq 'L3') -or (CustomAttribute5 -eq 'L3A') -or (CustomAttribute5 -eq 'L3B'))) -and (RecipientType -eq 'UserMailbox'))) ))
dg_emb_eve	((((RecipientTypeDetails -eq 'UserMailbox') -and (WindowsLiveID -eq '*@eveairmobility.com'))) -and (-not(Name -like 'SystemMailbox{*')) -and (-not(Name -like 'CAS_{*')) -and (-not(RecipientTypeDetailsValue -eq 'MailboxPlan')) -and (-not(RecipientTypeDetailsValue -eq 'DiscoveryMailbox')) -and (-not(RecipientTypeDetailsValue -eq 'PublicFolderMailbox')) -and (-not(RecipientTypeDetailsValue -eq 'ArbitrationMailbox')) -and (-not(RecipientTypeDetailsValue -eq 'AuditLogMailbox')) -and (-not(RecipientTypeDetailsValue -eq 'AuxAuditLogMailbox')) -and (-not(RecipientTypeDetailsValue -eq 'SupervisoryReviewPolicyMailbox')))
DG_EMB_GERENTES-GPX	((((CustomAttribute3 -eq 'GPX') -and (((CustomAttribute5 -eq 'L3') -or (CustomAttribute5 -eq 'L3A') -or (CustomAttribute5 -eq 'L3B'))) -and (RecipientType -eq 'UserMailbox'))) ))
DG_EMB_GERENTES-SJK	((((CustomAttribute3 -eq 'SJK') -and (((CustomAttribute5 -eq 'L3') -or (CustomAttribute5 -eq 'L3A') -or (CustomAttribute5 -eq 'L3B'))) -and (RecipientType -eq 'UserMailbox'))) ))
DG_EMB_GERENTES-ESC	((((CustomAttribute3 -eq 'ESC') -and (((CustomAttribute5 -eq 'L3') -or (CustomAttribute5 -eq 'L3A') -or (CustomAttribute5 -eq 'L3B'))) -and (RecipientType -eq 'UserMailbox'))) ))
DG_EMB_GERENTES-EDE	((((((CustomAttribute3 -eq 'EDE') -or (CustomAttribute3 -eq 'ELEB'))) -and (((CustomAttribute5 -eq 'L3B') -or (CustomAttribute5 -eq 'L3A') -or (CustomAttribute5 -eq 'L3'))) -and (RecipientType -eq 'UserMailbox'))) ))
DG_EMB_GERENTES-MLB	((((CustomAttribute3 -eq 'MLB') -and (((CustomAttribute5 -eq 'L3') -or (CustomAttribute5 -eq 'L3A') -or (CustomAttribute5 -eq 'L3B'))) -and (RecipientType -eq 'UserMailbox'))) ))
DG_EMB_GERENTES-SOD	((((CustomAttribute3 -eq 'SOD') -and (((CustomAttribute5 -eq 'L3') -or (CustomAttribute5 -eq 'L3A') -or (CustomAttribute5 -eq 'L3B'))) -and (RecipientType -eq 'UserMailbox'))) ))
DG_EMB_GERENTES-BJS	((((CustomAttribute3 -eq 'BJS') -and (((CustomAttribute5 -eq 'L3') -or (CustomAttribute5 -eq 'L3A') -or (CustomAttribute5 -eq 'L3B'))) -and (RecipientType -eq 'UserMailbox'))) ))
DG_EMB_GERENTES-BHZ	((((CustomAttribute3 -eq 'BHZ') -and (((CustomAttribute5 -eq 'L3') -or (CustomAttribute5 -eq 'L3A') -or (CustomAttribute5 -eq 'L3B'))) -and (RecipientType -eq 'UserMailbox'))) ))
DG_EMB_GERENTES-JAX	((((CustomAttribute3 -eq 'JAX') -and (((CustomAttribute5 -eq 'L3') -or (CustomAttribute5 -eq 'L3A') -or (CustomAttribute5 -eq 'L3B'))) -and (RecipientType -eq 'UserMailbox'))) ))
DG_EMB_GERENTES-BSB	((((CustomAttribute3 -eq 'BSB') -and (((CustomAttribute5 -eq 'L3') -or (CustomAttribute5 -eq 'L3A') -or (CustomAttribute5 -eq 'L3B'))) -and (RecipientType -eq 'UserMailbox'))) ))
DG_EMB_GERENTES-BOT	((((CustomAttribute3 -eq 'BOT') -and (((CustomAttribute5 -eq 'L3') -or (CustomAttribute5 -eq 'L3A') -or (CustomAttribute5 -eq 'L3B'))) -and (RecipientType -eq 'UserMailbox'))) ))
DG_EMB_GERENTES-FLN	((((((CustomAttribute5 -eq 'L3') -or (CustomAttribute5 -eq 'L3A') -or (CustomAttribute5 -eq 'L3B'))) -and (((CustomAttribute9 -eq 'FLN1') -or (CustomAttribute9 -eq 'FLN'))) -and (RecipientType -eq 'UserMailbox'))) ))
DG_EMB_GERENTES-AMS	((((((CustomAttribute3 -eq 'JNB') -or (CustomAttribute3 -eq 'LBG') -or (CustomAttribute3 -eq 'UK') -or (CustomAttribute3 -eq 'AMS') -or (CustomAttribute3 -eq 'MIMO'))) -and (((CustomAttribute5 -eq 'L3B') -or (CustomAttribute5 -eq 'L3A') -or (CustomAttribute5 -eq 'L3'))) -and (RecipientType -eq 'UserMailbox'))) ))
DG_EMB_GERENTES-FLL	((((((CustomAttribute3 -eq 'FLL') -or (CustomAttribute3 -eq 'AZ'))) -and (((CustomAttribute5 -eq 'L3B') -or (CustomAttribute5 -eq 'L3A') -or (CustomAttribute5 -eq 'L3'))) -and (RecipientType -eq 'UserMailbox'))) ))
DG_EMB_SUPERVISORES-BHZ	((((CustomAttribute3 -eq 'BHZ') -and (((CustomAttribute5 -eq 'L4') -or (CustomAttribute5 -eq 'L4A') -or (CustomAttribute5 -eq 'L4B'))) -and (RecipientType -eq 'UserMailbox'))) ))
DG_EMB_SUPERVISORES-BJS	((((CustomAttribute3 -eq 'BJS') -and (((CustomAttribute5 -eq 'L4') -or (CustomAttribute5 -eq 'L4A') -or (CustomAttribute5 -eq 'L4B'))) -and (RecipientType -eq 'UserMailbox'))) ))
DG_EMB_SUPERVISORES-BNA	((((((CustomAttribute3 -eq 'BNA') -or (CustomAttribute3 -eq 'MCN') -or (CustomAttribute3 -eq 'MQY'))) -and (((CustomAttribute5 -eq 'L4B') -or (CustomAttribute5 -eq 'L4A') -or (CustomAttribute5 -eq 'L4'))) -and (RecipientType -eq 'UserMailbox'))) ))
DG_EMB_SUPERVISORES-AMS	((((((CustomAttribute3 -eq 'LBG') -or (CustomAttribute3 -eq 'AMS') -or (CustomAttribute3 -eq 'MIMO'))) -and (((CustomAttribute5 -eq 'L4B') -or (CustomAttribute5 -eq 'L4A') -or (CustomAttribute5 -eq 'L4'))) -and (RecipientType -eq 'UserMailbox'))) ))
DG_EMB_SUPERVISORES-EDE	((((((CustomAttribute3 -eq '9901') -or (CustomAttribute3 -eq 'ELEB') -or (CustomAttribute3 -eq 'ETTE') -or (CustomAttribute3 -eq 'EDE'))) -and (((CustomAttribute5 -eq 'L4B') -or (CustomAttribute5 -eq 'L4A') -or (CustomAttribute5 -eq 'L4'))) -and (RecipientType -eq 'UserMailbox'))) ))
DG_EMB_SUPERVISORES-CGR	((((((CustomAttribute5 -eq 'L4') -or (CustomAttribute5 -eq 'L4A') -or (CustomAttribute5 -eq 'L4B'))) -and (((CustomAttribute9 -eq 'CGR1') -or (CustomAttribute9 -eq 'CGR'))) -and (RecipientType -eq 'UserMailbox'))) ))
DG_EMB_SUPERVISORES-GPX	((((CustomAttribute3 -eq 'GPX') -and (((CustomAttribute5 -eq 'L4') -or (CustomAttribute5 -eq 'L4A') -or (CustomAttribute5 -eq 'L4B'))) -and (RecipientType -eq 'UserMailbox'))) ))
DG_EMB_SUPERVISORES-JAX	((((CustomAttribute3 -eq 'JAX') -and (((CustomAttribute5 -eq 'L4') -or (CustomAttribute5 -eq 'L4A') -or (CustomAttribute5 -eq 'L4B'))) -and (RecipientType -eq 'UserMailbox'))) ))
DG_EMB_SUPERVISORES-BOT	((((CustomAttribute3 -eq 'BOT') -and (((CustomAttribute5 -eq 'L4') -or (CustomAttribute5 -eq 'L4A') -or (CustomAttribute5 -eq 'L4B'))) -and (RecipientType -eq 'UserMailbox'))) ))
DG_EMB_SUPERVISORES-EGM	((((CustomAttribute3 -eq 'EGM') -and (((CustomAttribute5 -eq 'L4') -or (CustomAttribute5 -eq 'L4A') -or (CustomAttribute5 -eq 'L4B'))) -and (RecipientType -eq 'UserMailbox'))) ))
DG_EMB_SUPERVISORES-PTE	((((CustomAttribute3 -eq 'PTE') -and (((CustomAttribute5 -eq 'L4') -or (CustomAttribute5 -eq 'L4A') -or (CustomAttribute5 -eq 'L4B'))) -and (RecipientType -eq 'UserMailbox'))) ))
DG_EMB_SUPERVISORES-MLB	((((CustomAttribute3 -eq 'MLB') -and (((CustomAttribute5 -eq 'L4') -or (CustomAttribute5 -eq 'L4A') -or (CustomAttribute5 -eq 'L4B'))) -and (RecipientType -eq 'UserMailbox'))) ))
DG_EMB_SUPERVISORES-ESC	((((CustomAttribute3 -eq 'ESC') -and (((CustomAttribute5 -eq 'L4') -or (CustomAttribute5 -eq 'L4A') -or (CustomAttribute5 -eq 'L4B'))) -and (RecipientType -eq 'UserMailbox'))) ))
DG_EMB_SUPERVISORES-FLN	((((((CustomAttribute5 -eq 'L4') -or (CustomAttribute5 -eq 'L4A') -or (CustomAttribute5 -eq 'L4B'))) -and (((CustomAttribute9 -eq 'FLN') -or (CustomAttribute9 -eq 'FLN1'))) -and (RecipientType -eq 'UserMailbox'))) ))
DG_EMB_SUPERVISORES-FLL	((((((CustomAttribute3 -eq 'FLL') -or (CustomAttribute3 -eq 'AZ'))) -and (((CustomAttribute5 -eq 'L4B') -or (CustomAttribute5 -eq 'L4A') -or (CustomAttribute5 -eq 'L4'))) -and (RecipientType -eq 'UserMailbox'))) ))
DG_EMB_VICE-PRESIDENTES	((((((((((((((((((((((((((((((((((((CustomAttribute3 -eq 'SJK') -or (CustomAttribute3 -eq 'EGM'))) -or (CustomAttribute3 -eq 'ESC'))) -or (CustomAttribute3 -eq 'LBG'))) -or (CustomAttribute3 -eq 'MLB'))) -and (((((CustomAttribute5 -eq 'L1B') -or (CustomAttribute5 -eq 'L1A'))) -or (CustomAttribute5 -eq 'L1'))))) -and (RecipientType -eq 'UserMailbox'))) -and (-not(CustomAttribute7 -like 'EVE*')))) -and (-not(Name -like 'SystemMailbox{*')))) -and (-not(Name -like 'CAS_{*')))) -and (-not(RecipientTypeDetailsValue -eq 'MailboxPlan')))) -and (-not(RecipientTypeDetailsValue -eq 'DiscoveryMailbox')))) -and (-not(RecipientTypeDetailsValue -eq 'PublicFolderMailbox')))) -and (-not(RecipientTypeDetailsValue -eq 'ArbitrationMailbox')))) -and (-not(RecipientTypeDetailsValue -eq 'AuditLogMailbox')))) -and (-not(RecipientTypeDetailsValue -eq 'AuxAuditLogMailbox')))) -and (-not(RecipientTypeDetailsValue -eq 'SupervisoryReviewPolicyMailbox')))) -and (-not(RecipientTypeDetailsValue -eq 'GuestMailUser')))) -and (-not(Name -like 'SystemMailbox{*')) -and (-not(Name -like 'CAS_{*')) -and (-not(RecipientTypeDetailsValue -eq 'MailboxPlan')) -and (-not(RecipientTypeDetailsValue -eq 'DiscoveryMailbox')) -and (-not(RecipientTypeDetailsValue -eq 'PublicFolderMailbox')) -and (-not(RecipientTypeDetailsValue -eq 'ArbitrationMailbox')) -and (-not(RecipientTypeDetailsValue -eq 'AuditLogMailbox')) -and (-not(RecipientTypeDetailsValue -eq 'AuxAuditLogMailbox')) -and (-not(RecipientTypeDetailsValue -eq 'SupervisoryReviewPolicyMailbox')))
DG_EMB_SUPERVISORES-SJK	((((CustomAttribute3 -eq 'SJK') -and (((CustomAttribute5 -eq 'L4') -or (CustomAttribute5 -eq 'L4A') -or (CustomAttribute5 -eq 'L4B'))) -and (RecipientType -eq 'UserMailbox'))) ))
DG_EMB_SUPERVISORES-VCP	((((CustomAttribute3 -eq 'VCP') -and (((CustomAttribute5 -eq 'L4') -or (CustomAttribute5 -eq 'L4A') -or (CustomAttribute5 -eq 'L4B'))) -and (RecipientType -eq 'UserMailbox'))) ))
DG_EMB_SUPERVISORES-TTE	((((CustomAttribute3 -eq 'TTE') -and (((CustomAttribute5 -eq 'L4') -or (CustomAttribute5 -eq 'L4A') -or (CustomAttribute5 -eq 'L4B'))) -and (RecipientType -eq 'UserMailbox'))) ))
DG_EMB_VICE-PRESIDENTES-INGLES	((((((((((((((((((((((((((((((((((((((((((((((((((((((((((((((((((((((((((CustomAttribute3 -eq 'AMS') -or (CustomAttribute3 -eq 'AUS'))) -or (CustomAttribute3 -eq 'AZ'))) -or (CustomAttribute3 -eq 'BDL'))) -or (CustomAttribute3 -eq 'BJS'))) -or (CustomAttribute3 -eq 'BNA'))) -or (CustomAttribute3 -eq 'BOS'))) -or (CustomAttribute3 -eq 'Brussels'))) -or (CustomAttribute3 -eq 'CAN_OFF_US'))) -or (CustomAttribute3 -eq 'DEU'))) -or (CustomAttribute3 -eq 'DXB'))) -or (CustomAttribute3 -eq 'FLL'))) -or (CustomAttribute3 -eq 'FRA'))) -or (CustomAttribute3 -eq 'HUN'))) -or (CustomAttribute3 -eq 'INB'))) -or (CustomAttribute3 -eq 'IND'))) -or (CustomAttribute3 -eq 'JAX'))) -or (CustomAttribute3 -eq 'JNB'))) -or (CustomAttribute3 -eq 'JOR'))) -or (CustomAttribute3 -eq 'JPN'))) -or (CustomAttribute3 -eq 'LAX'))) -or (CustomAttribute3 -eq 'LBG'))) -or (CustomAttribute3 -eq 'MCN'))) -or (CustomAttribute3 -eq 'MEM'))) -or (CustomAttribute3 -eq 'MIMO'))) -or (CustomAttribute3 -eq 'MLB'))) -or (CustomAttribute3 -eq 'Moscow'))) -or (CustomAttribute3 -eq 'MQY'))) -or (CustomAttribute3 -eq 'NZD'))) -or (CustomAttribute3 -eq 'SIN'))) -or (CustomAttribute3 -eq 'TITUS'))) -or (CustomAttribute3 -eq 'TIX'))) -or (CustomAttribute3 -eq 'UK'))) -or (CustomAttribute3 -eq 'Z2_OFF_US'))) -or (CustomAttribute3 -eq 'Z3_OFF_US'))) -and (-not(WindowsLiveID -eq '*@eveairmobility.com')))) -and (((((CustomAttribute5 -eq 'L1') -or (CustomAttribute5 -eq 'L1A'))) -or (CustomAttribute5 -eq 'L1B'))))) -and (-not(Name -like 'SystemMailbox{*')) -and (-not(Name -like 'CAS_{*')) -and (-not(RecipientTypeDetailsValue -eq 'MailboxPlan')) -and (-not(RecipientTypeDetailsValue -eq 'DiscoveryMailbox')) -and (-not(RecipientTypeDetailsValue -eq 'PublicFolderMailbox')) -and (-not(RecipientTypeDetailsValue -eq 'ArbitrationMailbox')) -and (-not(RecipientTypeDetailsValue -eq 'AuditLogMailbox')) -and (-not(RecipientTypeDetailsValue -eq 'AuxAuditLogMailbox')) -and (-not(RecipientTypeDetailsValue -eq 'SupervisoryReviewPolicyMailbox')))
DG_EMB_SUPERVISORES-SOD	((((CustomAttribute3 -eq 'SOD') -and (((CustomAttribute5 -eq 'L4') -or (CustomAttribute5 -eq 'L4A') -or (CustomAttribute5 -eq 'L4B'))) -and (RecipientType -eq 'UserMailbox'))) ))
DG_EMB_SUPERVISORES-SIN	((((CustomAttribute3 -eq 'SIN') -and (((CustomAttribute5 -eq 'L4') -or (CustomAttribute5 -eq 'L4A') -or (CustomAttribute5 -eq 'L4B'))) -and (RecipientType -eq 'UserMailbox'))) ))
DG_EMB_VICE-PRESIDENTE-PORTUGUES	((((((CustomAttribute3 -eq 'BHZ') -or (CustomAttribute3 -eq 'BOT') -or (CustomAttribute3 -eq 'BSB') -or (CustomAttribute3 -eq 'BSB2') -or (CustomAttribute3 -eq 'CGR') -or (CustomAttribute3 -eq 'EGM') -or (CustomAttribute3 -eq 'ELEB') -or (CustomAttribute3 -eq 'ESC') -or (CustomAttribute3 -eq 'ETTE') -or (CustomAttribute3 -eq 'EVO') -or (CustomAttribute3 -eq 'FLN') -or (CustomAttribute3 -eq 'GPX') -or (CustomAttribute3 -eq 'PRT') -or (CustomAttribute3 -eq 'PTE') -or (CustomAttribute3 -eq 'SJK') -or (CustomAttribute3 -eq 'SOD') -or (CustomAttribute3 -eq 'TTE') -or (CustomAttribute3 -eq 'VCP'))) -and (((CustomAttribute5 -eq 'L1') -or (CustomAttribute5 -eq 'L1A') -or (CustomAttribute5 -eq 'L1B'))) -and (RecipientType -eq 'UserMailbox'))) ))
L4TESTE	((((((Department -like 'DPS*') -and (CustomAttribute5 -like 'L4*'))) -and (((((((((((((CustomAttribute3 -eq 'SIN') -or (CustomAttribute3 -eq 'BJS'))) -or (CustomAttribute3 -eq 'AMS'))) -or (CustomAttribute3 -eq 'LBG'))) -or (CustomAttribute3 -eq 'MIMO'))) -or (CustomAttribute3 -eq 'FLL'))) -or (CustomAttribute3 -eq 'MLB'))))) -and (-not(Name -like 'SystemMailbox{*')) -and (-not(Name -like 'CAS_{*')) -and (-not(RecipientTypeDetailsValue -eq 'MailboxPlan')) -and (-not(RecipientTypeDetailsValue -eq 'DiscoveryMailbox')) -and (-not(RecipientTypeDetailsValue -eq 'PublicFolderMailbox')) -and (-not(RecipientTypeDetailsValue -eq 'ArbitrationMailbox')) -and (-not(RecipientTypeDetailsValue -eq 'AuditLogMailbox')) -and (-not(RecipientTypeDetailsValue -eq 'AuxAuditLogMailbox')) -and (-not(RecipientTypeDetailsValue -eq 'SupervisoryReviewPolicyMailbox')))
DDG_MCN_aLL	((((CustomAttribute3 -eq 'MCN') -and (CustomAttribute4 -eq 'Employee') -and (RecipientType -eq 'UserMailbox'))) ))
eve_rooms	((((Company -eq 'EVE SoluÃ§Ãµes de Mobilidade Ãreas Urbanas Ltda') -and (Alias -ne $null))) ))
DG_EMB-CARREIRA-Y-BHZ	((((CustomAttribute3 -eq 'BHZ') -and (CustomAttribute4 -eq 'Employee') -and (CustomAttribute8 -eq 'CY') -and (RecipientType -eq 'UserMailbox'))) ))
DG_EMB-CARREIRA-Y-BSB	((((CustomAttribute3 -eq 'BSB') -and (CustomAttribute4 -eq 'Employee') -and (CustomAttribute8 -eq 'CY') -and (RecipientType -eq 'UserMailbox'))) ))
DG_EMB-CARREIRA-Y-BOT	((((CustomAttribute3 -eq 'BOT') -and (CustomAttribute4 -eq 'Employee') -and (CustomAttribute8 -eq 'CY') -and (RecipientType -eq 'UserMailbox'))) ))
DG_EMB-CARREIRA-Y-EDE	((((((CustomAttribute3 -eq 'EDE') -or (CustomAttribute3 -eq '9901') -or (CustomAttribute3 -eq 'ELEB') -or (CustomAttribute3 -eq 'ETTE'))) -and (CustomAttribute4 -eq 'Employee') -and (CustomAttribute8 -eq 'CY') -and (RecipientType -eq 'UserMailbox'))) ))
DG_EMB-CARREIRA-Y-EGM	((((CustomAttribute3 -eq 'eGM') -and (CustomAttribute4 -eq 'employee') -and (CustomAttribute8 -eq 'CY') -and (RecipientType -eq 'UserMailbox'))) ))
DG_EMB-CARREIRA-Y-ESC	((((CustomAttribute3 -eq 'ESC') -and (CustomAttribute4 -eq 'Employee') -and (CustomAttribute8 -eq 'CY') -and (RecipientType -eq 'UserMailbox'))) ))
DG_EMB-CARREIRA-Y-GPX	((((CustomAttribute3 -eq 'GPX') -and (CustomAttribute4 -eq 'Employee') -and (CustomAttribute8 -eq 'CY') -and (RecipientType -eq 'UserMailbox'))) ))
DG_EMB-CARREIRA-Y-PTE	((((CustomAttribute3 -eq 'PTE') -and (CustomAttribute4 -eq 'Employee') -and (CustomAttribute8 -eq 'CY') -and (RecipientType -eq 'UserMailbox'))) ))
DG_EMB-CARREIRA-Y-VCP	((((CustomAttribute3 -eq 'VCP') -and (CustomAttribute4 -eq 'Employee') -and (CustomAttribute8 -eq 'CY') -and (RecipientType -eq 'UserMailbox'))) ))
DG_EMB-CARREIRA-Y-SJK	((((CustomAttribute3 -eq 'SJK') -and (CustomAttribute4 -eq 'Employee') -and (CustomAttribute8 -eq 'CY') -and (RecipientType -eq 'UserMailbox'))) ))
DG_EMB-Diretores-PRT	((((((CustomAttribute5 -eq 'L2') -or (CustomAttribute5 -eq 'L2A') -or (CustomAttribute5 -eq 'L2B'))) -and (CustomAttribute9 -eq 'PRT') -and (RecipientType -eq 'UserMailbox'))) ))
DG_EMB-CARREIRA-Y-FLN	((((CustomAttribute8 -eq 'CY') -and (((CustomAttribute9 -eq 'FLN') -or (CustomAttribute9 -eq 'FLN1'))) -and (RecipientType -eq 'UserMailbox'))) ))
DG_EMBCARREIRAY-EVE	((((((RecipientTypeDetails -eq 'UserMailbox') -and (WindowsLiveID -eq '*@eveairmobility.com'))) -and (CustomAttribute8 -eq 'CY'))) -and (-not(Name -like 'SystemMailbox{*')) -and (-not(Name -like 'CAS_{*')) -and (-not(RecipientTypeDetailsValue -eq 'MailboxPlan')) -and (-not(RecipientTypeDetailsValue -eq 'DiscoveryMailbox')) -and (-not(RecipientTypeDetailsValue -eq 'PublicFolderMailbox')) -and (-not(RecipientTypeDetailsValue -eq 'ArbitrationMailbox')) -and (-not(RecipientTypeDetailsValue -eq 'AuditLogMailbox')) -and (-not(RecipientTypeDetailsValue -eq 'AuxAuditLogMailbox')) -and (-not(RecipientTypeDetailsValue -eq 'SupervisoryReviewPolicyMailbox')))
TESTE-EMBRAERPREV	((((UserPrincipalName -eq '*embraerprev.com.br#EXT#@embraer.onmicrosoft.com') -or (UserPrincipalName -eq 'paulo.monginho@ogma.pt'))) -and (-not(Name -like 'SystemMailbox{*')) -and (-not(Name -like 'CAS_{*')) -and (-not(RecipientTypeDetailsValue -eq 'MailboxPlan')) -and (-not(RecipientTypeDetailsValue -eq 'DiscoveryMailbox')) -and (-not(RecipientTypeDetailsValue -eq 'PublicFolderMailbox')) -and (-not(RecipientTypeDetailsValue -eq 'ArbitrationMailbox')) -and (-not(RecipientTypeDetailsValue -eq 'AuditLogMailbox')) -and (-not(RecipientTypeDetailsValue -eq 'AuxAuditLogMailbox')) -and (-not(RecipientTypeDetailsValue -eq 'SupervisoryReviewPolicyMailbox')))
